{
    "24": 1,
    "25": 2,
    "26": 3,
    "27": 4,
    "28": 5,
    "29": 6,
    "30": 7,
    "31": 8,
    "32": 9,
    "33": 10,
    "34": 11,
    "35": 12,
    "36": 13,
    "37": 14,
    "38": 15,
    "39": 16,
    "40": 17,
    "41": 18,
    "42": 19,
    "43": 20,
    "44": 21,
    "45": 22,
    "46": 23,
    "47": 24,
    "48": 25,
    "49": 26,
    "50": 27,
    "51": 28,
    "52": 29,
    "53": 30,
    "54": 31,
    "55": 32,
    "56": 33,
    "57": 34,
    "58": 35,
    "59": 36,
    "60": 37,
    "61": 38,
    "62": 39,
    "63": 40,
    "64": 41,
    "65": 42,
    "66": 43,
    "67": 44,
    "68": 45,
    "69": 46,
    "70": 47,
    "72": 48,
    "73": 49,
    "74": 50,
    "75": 51,
    "76": 52,
    "77": 53,
    "78": 54,
    "79": 55,
    "80": 56,
    "81": 57,
    "82": 58,
    "83": 59,
    "84": 60,
    "85": 61,
    "86": 62,
    "91": 63,
    "92": 64,
    "94": 65,
    "95": 66,
    "96": 67,
    "97": 68,
    "99": 69,
    "101": 70,
    "102": 71,
    "103": 72,
    "104": 73,
    "108": 74,
    "112": 75,
    "113": 76,
    "116": 77,
    "117": 78,
    "118": 79,
    "119": 80,
    "120": 81,
    "125": 82,
    "126": 83,
    "127": 84,
    "129": 85,
    "130": 86,
    "131": 87,
    "132": 88,
    "134": 89,
    "135": 90,
    "136": 91,
    "137": 92,
    "138": 93,
    "140": 94,
    "141": 95,
    "143": 96,
    "144": 97,
    "146": 98,
    "147": 99,
    "148": 100,
    "149": 101,
    "150": 102,
    "151": 103,
    "152": 104,
    "155": 105,
    "158": 106,
    "159": 107,
    "160": 108,
    "170": 109,
    "171": 110,
    "172": 111,
    "173": 112,
    "174": 113,
    "175": 114,
    "176": 115,
    "177": 116,
    "178": 117,
    "184": 118,
    "186": 119,
    "187": 120,
    "188": 121,
    "190": 122,
    "191": 123,
    "192": 124,
    "193": 125,
    "194": 126,
    "196": 127,
    "197": 128,
    "198": 129,
    "199": 130,
    "200": 131,
    "201": 132,
    "207": 133,
    "209": 134,
    "211": 135,
    "212": 136,
    "213": 137,
    "214": 138,
    "215": 139,
    "217": 140,
    "220": 141,
    "221": 142,
    "222": 143,
    "224": 144,
    "226": 145,
    "229": 146,
    "230": 147,
    "232": 148,
    "233": 149,
    "234": 150,
    "235": 151,
    "236": 152,
    "237": 153,
    "242": 154,
    "243": 155,
    "244": 156,
    "246": 157,
    "247": 158,
    "249": 159,
    "254": 160,
    "255": 161,
    "256": 162,
    "257": 163,
    "258": 164,
    "259": 165,
    "260": 166,
    "261": 167,
    "263": 168,
    "268": 169,
    "269": 170,
    "270": 171,
    "271": 172,
    "275": 173,
    "277": 174,
    "278": 175,
    "282": 176,
    "283": 177,
    "284": 178,
    "285": 179,
    "286": 180,
    "287": 181,
    "288": 182,
    "290": 183,
    "291": 184,
    "294": 185,
    "299": 186,
    "300": 187,
    "302": 188,
    "303": 189,
    "304": 190,
    "305": 191,
    "306": 192,
    "307": 193,
    "311": 194,
    "315": 195,
    "316": 196,
    "317": 197,
    "318": 198,
    "319": 199,
    "320": 200,
    "322": 201,
    "323": 202,
    "324": 203,
    "325": 204,
    "326": 205,
    "327": 206,
    "329": 207,
    "330": 208,
    "331": 209,
    "332": 210,
    "333": 211,
    "334": 212,
    "335": 213,
    "336": 214,
    "338": 215,
    "340": 216,
    "341": 217,
    "342": 218,
    "344": 219,
    "346": 220,
    "348": 221,
    "349": 222,
    "350": 223,
    "351": 224,
    "352": 225,
    "353": 226,
    "354": 227,
    "355": 228,
    "356": 229,
    "357": 230,
    "358": 231,
    "360": 232,
    "361": 233,
    "362": 234,
    "363": 235,
    "364": 236,
    "365": 237,
    "366": 238,
    "367": 239,
    "371": 240,
    "372": 241,
    "373": 242,
    "374": 243,
    "375": 244,
    "376": 245,
    "377": 246,
    "378": 247,
    "379": 248,
    "381": 249,
    "382": 250,
    "386": 251,
    "387": 252,
    "388": 253,
    "389": 254,
    "391": 255,
    "392": 256,
    "393": 257,
    "394": 258,
    "395": 259,
    "396": 260,
    "397": 261,
    "398": 262,
    "399": 263,
    "400": 264,
    "401": 265,
    "402": 266,
    "403": 267,
    "404": 268,
    "405": 269,
    "406": 270,
    "407": 271,
    "408": 272,
    "409": 273,
    "410": 274,
    "411": 275,
    "412": 276,
    "413": 277,
    "414": 278,
    "415": 279,
    "416": 280,
    "417": 281,
    "418": 282,
    "419": 283,
    "420": 284,
    "421": 285,
    "422": 286,
    "423": 287,
    "424": 288,
    "425": 289,
    "426": 290,
    "427": 291,
    "428": 292,
    "429": 293,
    "430": 294,
    "431": 295,
    "432": 296,
    "433": 297,
    "434": 298,
    "435": 299,
    "436": 300,
    "437": 301,
    "438": 302,
    "439": 303,
    "440": 304,
    "441": 305,
    "442": 306,
    "443": 307,
    "444": 308,
    "445": 309,
    "446": 310,
    "447": 311,
    "448": 312,
    "449": 313,
    "450": 314,
    "451": 315,
    "452": 316,
    "453": 317,
    "454": 318,
    "455": 319
}